tileswide 25
tileshigh 20
tilewidth 32
tileheight 32

layer 0
10,10,10,10,10,10,10,10,10,10,10,10,10,10,10,20,15,15,15,21,10,10,10,10,10,
10,10,10,10,10,10,10,10,10,10,10,10,20,15,15,14,9,9,9,16,15,15,15,21,10,
10,10,10,10,10,10,10,10,10,10,20,15,14,9,8,2,9,9,8,1,1,1,2,16,21,
10,10,10,10,10,10,10,10,10,10,13,9,9,9,6,4,9,9,6,5,5,5,4,9,17,
10,10,10,10,10,10,10,10,10,10,13,9,8,2,18,11,11,11,11,12,9,9,9,18,22,
10,10,10,10,10,10,10,10,10,20,14,9,6,4,16,21,10,10,10,19,12,9,9,17,10,
10,10,10,10,10,10,10,10,10,13,9,9,9,9,9,16,15,21,10,10,19,11,11,22,10,
10,10,20,15,15,15,15,15,15,14,9,9,9,9,9,9,9,16,21,10,10,10,10,10,10,
10,10,13,9,9,9,9,9,9,9,9,9,8,1,2,9,9,9,16,21,20,15,15,21,10,
10,10,13,9,18,11,11,11,11,12,9,9,7,0,3,9,9,9,9,17,13,9,9,17,10,
10,10,13,9,17,10,10,10,10,19,11,12,6,5,4,9,9,8,2,17,13,9,9,17,10,
10,10,13,9,17,10,10,10,10,10,10,13,9,9,9,9,9,7,3,17,19,11,11,22,10,
10,10,13,9,17,10,10,10,10,10,10,13,9,9,9,9,9,6,4,17,20,15,15,15,21,
10,10,13,9,17,10,10,10,10,10,10,13,9,9,8,9,18,11,11,22,13,8,2,1,17,
10,20,14,9,16,21,10,10,10,10,10,19,11,12,7,3,16,15,15,15,14,7,0,3,17,
10,13,9,9,9,17,10,10,10,10,10,10,10,13,9,4,9,9,9,9,9,6,5,4,17,
10,13,8,1,2,17,10,10,10,10,10,10,10,13,9,9,9,9,18,12,9,9,9,18,22,
10,13,6,5,4,17,10,10,10,10,10,10,10,19,11,11,11,11,22,19,11,11,11,22,10,
10,13,9,9,9,17,10,10,10,10,10,10,10,10,10,10,10,10,10,10,10,10,10,10,10,
10,19,11,11,11,22,10,10,10,10,10,10,10,10,10,10,10,10,10,10,10,10,10,10,10,

layer 1
0,0,0,0,0,0,0,0,0,0,0,0,0,0,0,1,1,1,1,1,0,0,0,0,0
0,0,0,0,0,0,0,0,0,0,0,0,1,1,1,1,0,0,0,1,1,1,1,1,0
0,0,0,0,0,0,0,0,0,0,1,1,1,0,0,0,0,0,0,0,0,0,0,1,1
0,0,0,0,0,0,0,0,0,0,1,0,0,0,0,0,0,0,0,0,0,0,0,0,1
0,0,0,0,0,0,0,0,0,0,1,0,0,0,1,1,1,1,1,1,0,0,0,1,1
0,0,0,0,0,0,0,0,0,1,1,0,0,0,1,1,0,0,0,1,1,0,0,1,0
0,0,0,0,0,0,0,0,0,1,0,0,0,0,0,1,1,1,0,0,1,1,1,1,0
0,0,1,1,1,1,1,1,1,1,0,0,0,0,0,0,0,1,1,0,0,0,0,0,0
0,0,1,0,0,0,0,0,0,0,0,0,0,0,0,0,0,0,1,1,1,1,1,1,0
0,0,1,0,1,1,1,1,1,1,0,0,0,0,0,0,0,0,0,1,1,0,0,1,0
0,0,1,0,1,0,0,0,0,1,1,1,0,0,0,0,0,0,0,1,1,0,0,1,0
0,0,1,0,1,0,0,0,0,0,0,1,0,0,0,0,0,0,0,1,1,0,0,1,0
0,0,1,0,1,0,0,0,0,0,0,1,0,0,0,0,0,0,0,1,1,0,0,1,1
0,0,1,0,1,0,0,0,0,0,0,1,0,0,0,0,1,1,1,1,1,0,0,0,1
0,1,1,0,1,1,0,0,0,0,0,1,1,1,0,0,1,1,1,1,1,0,0,0,1
0,1,0,0,0,1,0,0,0,0,0,0,0,1,0,0,0,0,0,0,0,0,0,0,1
0,1,0,0,0,1,0,0,0,0,0,0,0,1,0,0,0,0,1,1,0,0,0,1,1
0,1,0,0,0,1,0,0,0,0,0,0,0,1,1,1,1,1,1,1,1,1,1,1,0
0,1,0,0,0,1,0,0,0,0,0,0,0,0,0,1,0,0,0,0,0,0,0,0,0
0,1,1,1,1,1,0,0,0,0,0,0,0,0,0,0,0,0,0,0,0,0,0,0,0

